[
    ["X", "X", "X", "X", "X", "X", "X", "X", "X", "X", "X", "X", "X", "X", "X", "\n"],
    ["M", " ", " ", "X", "X", "X", "X", " ", " ", " ", " ", "X", "X", "X", "X", "\n"],
    ["X", "X", " ", "X", "X", "X", "X", "X", "X", "X", " ", "X", "X", "X", "X", "\n"],
    ["X", "X", " ", " ", " ", " ", " ", " ", " ", " ", " ", " ", " ", " ", "X", "\n"],
    ["X", "X", "X", " ", "X", "X", "X", " ", "X", "X", "X", "X", " ", "X", "X", "\n"],
    ["X", "X", "X", " ", "X", "X", "X", " ", "X", "X", "X", "X", " ", "X", "X", "\n"],
    ["X", "X", "X", "X", "X", "X", "X", " ", "X", "X", "X", "X", " ", " ", "X", "\n"],
    ["X", "X", "X", "X", "X", "X", "X", " ", "X", "X", "X", "X", " ", " ", "X", "\n"],
    ["X", "X", " ", " ", " ", "X", "X", " ", "X", "X", "X", "X", " ", " ", "X", "\n"],
    ["X", "X", " ", "X", " ", "X", "X", " ", " ", " ", "X", "X", "X", " ", "X", "\n"],
    ["X", "X", " ", "X", " ", "X", " ", " ", "X", " ", "X", "X", "X", " ", "X", "\n"],
    ["X", "X", " ", "X", " ", "X", " ", "X", "X", " ", "X", "X", "X", "X", "X", "\n"],
    ["X", "X", "X", "X", " ", " ", " ", "X", "X", " ", " ", " ", " ", "X", "X", "\n"],
    ["X", "X", "X", "X", "X", " ", "X", "X", "X", "X", "X", "X", " ", "X", "X", "\n"],
    ["X", "X", "X", "X", "X", "X", "X", "X", "X", "X", "X", "X", "G", "X", "X", "\n"]
]
