[
    ["W", "W", "W", "W", "W", "W", "W", "W", "W", "W", "W", "W", "W", "W", "W", "\n"],
    ["M", " ", " ", "W", "W", "W", "W", " ", " ", " ", " ", "W", "W", "W", "W", "\n"],
    ["W", "W", " ", "W", "W", "W", "W", "W", "W", "W", " ", "W", "W", "W", "W", "\n"],
    ["W", "W", " ", " ", " ", " ", " ", " ", " ", " ", " ", " ", " ", " ", "W", "\n"],
    ["W", "W", "W", " ", "W", "W", "W", " ", "W", "W", "W", "W", " ", "W", "W", "\n"],
    ["W", "W", "W", " ", "W", "W", "W", " ", "W", "W", "W", "W", " ", "W", "W", "\n"],
    ["W", "W", "W", "W", "W", "W", "W", " ", "W", "W", "W", "W", " ", " ", "W", "\n"],
    ["W", "W", "W", "W", "W", "W", "W", " ", "W", "W", "W", "W", " ", " ", "W", "\n"],
    ["W", "W", " ", " ", " ", "W", "W", " ", "W", "W", "W", "W", " ", " ", "W", "\n"],
    ["W", "W", " ", "W", " ", "W", "W", " ", " ", " ", "W", "W", "W", " ", "W", "\n"],
    ["W", "W", " ", "W", " ", "W", " ", " ", "W", " ", "W", "W", "W", " ", "W", "\n"],
    ["W", "W", " ", "W", " ", "W", " ", "W", "W", " ", "W", "W", "W", "W", "W", "\n"],
    ["W", "W", "W", "W", " ", " ", " ", "W", "W", " ", " ", " ", " ", "W", "W", "\n"],
    ["W", "W", "W", "W", "W", " ", "W", "W", "W", "W", "W", "W", " ", "W", "W", "\n"],
    ["W", "W", "W", "W", "W", "W", "W", "W", "W", "W", "W", "W", "G", "W", "W", "\n"]
]
