[
    ["X", "X", "X", "X", "X", "X", "X", "X", "X", "X", "X", "X", "X", "X", "X", "\n"],
    ["M", " ", " ", "X", "X", "X", "X", "X", "X", "X", "X", "X", "X", "X", "X", "\n"],
    ["X", "X", " ", "X", "X", "X", "X", "X", "X", "X", "X", "X", "X", "X", "X", "\n"],
    ["X", "X", " ", " ", " ", " ", " ", " ", " ", " ", " ", " ", " ", " ", "G", "\n"],
    ["X", "X", "X", "X", "X", "X", "X", " ", "X", "X", "X", "X", "X", "X", "X", "\n"],
    ["X", "X", "X", "X", "X", "X", "X", " ", "X", "X", "X", "X", "X", "X", "X", "\n"],
    ["X", "X", "X", "X", "X", "X", "X", " ", "X", "X", "X", "X", "X", "X", "X", "\n"],
    ["X", "X", "X", "X", "X", "X", "X", " ", "X", "X", "X", "X", "X", "X", "X", "\n"],
    ["X", "X", "X", "X", "X", "X", "X", " ", "X", "X", "X", "X", "X", "X", "X", "\n"],
    ["X", "X", "X", "X", "X", "X", "X", "X", "X", "X", "X", "X", "X", "X", "X", "\n"],
    ["X", "X", "X", "X", "X", "X", "X", "X", "X", "X", "X", "X", "X", "X", "X", "\n"],
    ["X", "X", "X", "X", "X", "X", "X", "X", "X", "X", "X", "X", "X", "X", "X", "\n"],
    ["X", "X", "X", "X", "X", "X", "X", "X", "X", "X", "X", "X", "X", "X", "X", "\n"],
    ["X", "X", "X", "X", "X", "X", "X", "X", "X", "X", "X", "X", "X", "X", "X", "\n"],
    ["X", "X", "X", "X", "X", "X", "X", "X", "X", "X", "X", "X", "X", "X", "X", "\n"]
]
