[
    ["W", "W", "W", "W", "W", "W", "W", "W", "W", "W", "W", "W", "W", "W", "W", "\n"],
    ["M", " ", " ", "W", "W", "W", "W", "W", "W", "W", "W", "W", "W", "W", "W", "\n"],
    ["W", "W", " ", "W", "W", "W", "W", "W", "W", "W", "W", "W", "W", "W", "W", "\n"],
    ["W", "W", " ", " ", " ", " ", " ", " ", " ", " ", " ", " ", " ", "e", "G", "\n"],
    ["W", "W", "W", "W", "W", "W", "W", " ", "W", "W", "W", "W", "W", "W", "W", "\n"],
    ["W", "W", "W", "W", "W", "W", "W", " ", "W", "W", "W", "W", "W", "W", "W", "\n"],
    ["W", "W", "W", "W", "W", "W", "W", " ", "W", "W", "W", "W", "W", "W", "W", "\n"],
    ["W", "W", "W", "W", "W", "W", "W", "W", "W", "W", "W", "W", "W", "W", "W", "\n"],
    ["W", "W", "W", "W", "W", "W", "W", "W", "W", "W", "W", "W", "W", "W", "W", "\n"],
    ["W", "W", "W", "W", "W", "W", "W", "W", "W", "W", "W", "W", "W", "W", "W", "\n"],
    ["W", "W", "W", "W", "W", "W", "W", "W", "W", "W", "W", "W", "W", "W", "W", "\n"],
    ["W", "W", "W", "W", "W", "W", "W", "W", "W", "W", "W", "W", "W", "W", "W", "\n"],
    ["W", "W", "W", "W", "W", "W", "W", "W", "W", "W", "W", "W", "W", "W", "W", "\n"],
    ["W", "W", "W", "W", "W", "W", "W", "W", "W", "W", "W", "W", "W", "W", "W", "\n"],
    ["W", "W", "W", "W", "W", "W", "W", "W", "W", "W", "W", "W", "W", "W", "W", "\n"]
]
