XXXXXXXXXXXXXXX
M       XXXXXXX
XXXXXXX XXXXXXX
XXXXXXX      XX
XXXXXXX XXXX XX
XXXXXXX XXXX  G
XXXXXXX XXXXXXX
XXXXXXXXXXXXXXX
XXXXXXXXXXXXXXX
XXXXXXXXXXXXXXX
XXXXXXXXXXXXXXX
XXXXXXXXXXXXXXX
XXXXXXXXXXXXXXX
XXXXXXXXXXXXXXX
XXXXXXX XXXXXXX
