XXXXXXXXXXXXXXX
M       XXXXXXX
XXXXXXX      XX
XXXXXXXXXXXX  G
XXXXXXX XXXXXXX
